10 7  
6  2
xxxxxxxxxx          
x  xxx   x
x  x     x
x        x
x        x
x        x
xx xxxxxxx